**************
* * * ***  *B*
* * *   * ** *
*   * *   ** *
** ** * * ** *
**    * *    *
**** ** ******
*A   **      *
**************