*************
*          B*
* ********* *
* *       * *
* * ***** * *
*   *     * *
*** * ***** *
A   *       *
*************